S = INDICATIVA | EXPRESION | PREGUNTA | SINO | IMPERATIVO | taso S
INDICATIVA =  CONDITIONAL SUJ  LIPRED | CONDITIONAL MISINA PRED
IMPERATIVO = CONDITIONAL o PRED | SN o , S | CONDITIONAL SUJ o PRED | CONDITIONAL MISINA o PRED 
EXPRESION = SN | mu ! | NOMBRE ! | A ! | INDICATIVA A ! | SN A ! | IMPERATIVO A !  
A = a | kin | o
CONDITIONAL = λ | INDICATIVA la , CONDITIONAL | SN la , CONDITIONAL 
PREGUNTA = PREGUNTASEME | INDICATIVA , anu seme ? | CONDITIONAL SUJ li PREDPREGUNTASINO | CONDITIONAL MISINA PREDPREGUNTASINO
PREGUNTASEME = seme li PRED ? | SNSEME li PRED ? | CONDITIONALSEME SUJ li PRED | CONDITIONALSEME MISINA PRED | CONDITIONAL SUJ li PREDPREGUNTASEME | CONDITIONAL MISINA PREDPREGUNTASEME   
CONDITIONALSEME = CONDITIONAL tenpo seme la, CONDITIONAL | CONDITIONAL SN pi mute seme la, CONDITIONAL | CONDITIONAL tan seme la, CONDITIONAL | CONDITIONAL kepeken seme la, CONDITIONAL | CONDITIONAL SNSEME la, CONDITIONAL | CONDITIONAL PREGUNTASEMECONDITIONAL la, CONDITIONAL
PREGUNTASEMECONDITIONAL = seme li PRED ? | SNSEME li PRED ? | SUJ li PREDPREGUNTASEME | MISINA PREDPREGUNTASEME
SINO= V | ala | V ala
SUJ = NOMBRENOMISINA | NOMBRE NOMBRE | NOMBRE SN | NOMBRE pi SN NOMBRE | SN en SN | SN anu SN
SN = NOMBRE | NOMBRE NOMBRE | NOMBRE SN | NOMBRE pi SN NOMBRE | SN en SN | SN anu SN
SNSEME = NOMBRE seme | NOMBRE pi SN seme
LIPRED = li PREDSINCC CC | li PREDSINCC LIPRED CC
PRED = PREDSINCC CC | PREDSINCC LIPRED CC
PREDPREGUNTASINO = PREDPREGUNTASINOSINCC CC ?
PREDPREGUNTASINOSINCC = VALAV | VALAV NOMBRE | VALAV CD | VALAV NOMBRE CD 
VALAV= VERBOALAVERBO | PREVERBOALAPREVERBO NOMBRE
PREDSINCC = SN | V | V NOMBRE | V CD | V NOMBRE CD | PALABRAEXTRANJERA
PREDPREGUNTASEME = PREDSINCC CCSEME ? | PREDSINCCSEME CC ?
PREDSINCCSEME = VSEME | VSEME NOMBRE | VSEME CD | VSEME NOMBRE CD | V CDSEME | V NOMBRE CDSEME | V seme CD | V seme
CC = λ | PREPOSICION SN
CCSEME = PREPOSICION seme | PREPOSICION SNSEME | seme
CD = e SN | e SN CD
CDSEME = e seme | e SN pi mute seme
V = PREV NOMBRE
VSEME = seme NOMBRE | PREV seme
PREV = λ | PREVERBO
NOMBRENOMISINA = NOMBREPROPIO | PREPOSICION | mu | kin | kon | wile | anpa | akesi | ale | ali | esun | ijo | ilo | insa | jan | kala | kasi | kili | kiwen | ko | kulupu | kute | lawa | len | linja | lipu | luka | lukin | oko | lupa | ma | mama | mani | meli | mije | monsi | mun | mute | nanpa | sewi | sijelo | sike | sinpin | sitelen | soweli | suno | supa | telo | tenpo | tomo | uta | waso | nasin | nena | nimi | noka | ona | palisa | pan | pipi | poka | poki | selo | ala | ante | awen | ike | jaki | jelo | kama | ken | kule | lape | laso | lete | lili | pilin | loje | moli | musi | sin | namako | suli | suwi | taso | tawa | walo | wawa | weka | nasa | ni | pakala | pimeja | pini | pona | pu | sama | seli alasa | jo | kalama | lawa | moku | sona | toki | unpa | utala | olin | open | pali | pana | wan | tu
NOMBRE = mi | sina | NOMBREPROPIO | PREPOSICION | kin | kon | wile | anpa | akesi | ale | ali | esun | ijo | ilo | insa | jan | kala | kasi | kili | kiwen | ko | kulupu | kute | lawa | len | linja | lipu | luka | lukin | oko | lupa | ma | mama | mani | meli | mije | monsi | mun | mute | nanpa | sewi | sijelo | sike | sinpin | sitelen | soweli | suno | supa | telo | tenpo | tomo | uta | waso | nasin | nena | nimi | noka | ona | palisa | pan | pipi | poka | poki | selo | ala | ante | awen | ike | jaki | jelo | kama | ken | kule | lape | laso | lete | lili | pilin | loje | moli | musi | sin | namako | suli | suwi | taso | tawa | walo | wawa | weka | nasa | ni | pakala | pimeja | pini | pona | pu | sama | seli alasa | jo | kalama | lawa | moku | sona | toki | unpa | utala | olin | open | pali | pana | wan | tu 
VERBOALAVERBO= mu ala mu | kon ala kon | kin ala kin | wile ala wile | anpa ala anpa | akesi ala akesi | ale ala ale | ali ala ali | esun ala esun | ijo ala ijo | ilo ala ilo | insa ala insa | jan ala jan | kala ala kala | kasi ala kasi | kili ala kili | kiwen ala kiwen | ko ala ko | kulupu ala kulupu | kute ala kute | lawa ala lawa | len ala len | linja ala linja | lipu ala lipu | luka ala luka | lukin ala lukin | oko ala oko | lupa ala lupa | ma ala ma | mama ala mama | mani ala mani | meli ala meli | mije ala mije | monsi ala monsi | mun ala mun | mute ala mute | nanpa ala nanpa | sewi ala sewi | sijelo ala sijelo | sike ala sike | sinpin ala sinpin | sitelen ala sitelen | soweli ala soweli | suno ala suno | supa ala supa | telo ala telo | tenpo ala tenpo | tomo ala tomo | uta ala uta | waso ala waso | nasin ala nasin | nena ala nena | nimi ala nimi | noka ala noka | ona ala ona | palisa ala palisa | pan ala pan | pipi ala pipi | poka ala poka | poki ala poki | selo ala selo | ala ala ala | ante ala ante | awen ala awen | ike ala ike | jaki ala jaki | jelo ala jelo | kama ala kama | ken ala ken | kule ala kule | lape ala lape | laso ala laso | lete ala lete | lili ala lili | pilin ala pilin | loje ala loje | moli ala moli | musi ala musi | sin ala sin | namako ala namako | suli ala suli | suwi ala suwi | taso ala taso | tawa ala tawa | walo ala walo | wawa ala wawa | weka ala weka | nasa ala nasa | ni ala ni | pakala ala pakala | pimeja ala pimeja | pini 
ala pini | pona ala pona | pu ala pu | sama ala sama | seli alasa ala seli alasa | jo ala jo | kalama ala kalama | lawa ala lawa | moku ala moku | sona ala sona | toki ala toki | unpa ala unpa | utala ala utala | olin ala olin | open ala open | pali ala pali | pana ala pana
MISINA= mi | sina
NOMBREPROPIO = SN PALABRAEXTRANJERA
PREVERBO = awen | ken | lukin | oko | sona | wile
PREVERBOALAPREVERBO = awen ala awen | ken ala ken | lukin ala lukin | oko ala oko | sona ala sona | wile ala wile
PREPOSICION = kepeken | lon | tan | taso | tawa
PALABRAEXTRANJERA = Pablo | Epelanto | Alapi | Potuke | Ansa | Isa | Isale | Mawijo | Sili